11111111
10000001
100C0001
10010001
100C0001
10000001
110E0P01
11111111