111111111111
1C1000000E01
110000000001
100000111001
11C111111001
1000000000P1
111111111111