11111111
1000P001
10010001
10010001
10010001
10000001
110E0001
11111111