11111111
1000P001
100C0P01
10010001
100C0001
10000001
110E0001
11111111