111111111111
1C0000000000
110000000001
100000111001
11C111111001
1000000000P1
1000000000E1
111111111111