111111111111
1CE000000001
110000000001
100000111001
11C111111001
1000000000P1
100000000001
111111111111